1111111111111111111111111111111111
0E0000000000000C00000C000000000000
0010010100100000101001000000010100
0010010010101010001001000000010100
0P0000000C00C0000000000000000000C0
1111111111111111111111111111111111
