11111111111111111111111111111111111111111111111111111111111111111111111111111111111111111111111111111111111111111111111111111111111111111111111111111111111111111111111111111111111
1000000000000000000000000000000000000000000000000000000000000000C00000000000000000000000000000000000000000000000000000000000000000C000000000000000000000000000000000000000000000001
1000000000000000000000000000000000000000000000000000000000000000C00000000000000000000000000000000000000000000000000000000000000000C000000000000000000000000000000000000000000000001
1000000000000000000000000000000000000000000000000000000000000000C0000000000000000000000E000000000000000000000000000000000000000000C000000000000000000000000000000000000000000000001
10P0000000000000000000000000000000000000000000000000000000000000C00000000000000000000000000000000000000000000000000000000000000000C000000000000000000000000000000000000000000000001
11111111111111111111111111111111111111111111111111111111111111111111111111111111111111111111111111111111111111111111111111111111111111111111111111111111111111111111111111111111111
